25 35
╔════════════════╦════════════════╗
║0∙∙∙∙∙∙∙∙∙∙∙∙∙∙∙║∙∙∙∙∙∙∙∙∙∙∙∙∙∙∙∙║
║∙┌────┐∙┌─────┐∙║∙┌────┐∙┌─────┐∙║
║∙│    │∙│     │∙║∙│    │∙│     │∙║
║∙└────┘∙└─────┘∙║∙└────┘∙└─────┘∙║
║∙∙∙∙∙∙∙∙∙∙∙∙∙∙∙∙∙∙∙∙∙∙∙∙∙∙∙∙∙∙∙∙0║
║∙┌────┐∙┌┐∙┌────────┐∙┌┐∙┌─────┐∙║
║∙└────┘∙││∙└───┐┌───┘∙││∙└─────┘∙║
║∙∙∙∙∙∙∙∙││∙∙∙∙∙││∙∙∙∙∙││∙∙∙∙∙∙∙∙∙║
╚══════╗∙│└───┐∙││∙┌───┘│∙╔═══════╝
       ║∙│┌───┘∙└┘∙└───┐│∙║
       ║∙││∙∙∙∙∙∙∙∙∙∙∙∙││∙║
       ║∙││.╔═══  ═══╗.││∙║
╔══════╝∙││∙║M  M  M ║∙││∙╚═══════╗
║∙∙∙∙∙∙∙∙││∙╚════════╝∙││∙∙∙∙∙∙∙∙∙║
║∙┌────┐∙││∙∙∙∙∙∙∙∙∙∙∙∙││∙┌─────┐∙║
║∙│    │∙│└────────────┘│∙│	│∙║
║∙│    │∙└──────────────┘∙│     │∙║
║∙└────┘∙∙∙∙∙∙∙∙∙∙∙∙∙∙∙∙∙∙└─────┘∙║
║0∙∙∙∙∙∙∙┌─────┐∙║∙┌────┐∙∙∙∙∙∙∙∙ ║
║∙┌────┐∙│     │∙║∙│    │∙┌─────┐∙║
║∙│    │∙│     │∙║∙│    │∙│     │∙║
║∙└────┘∙└─────┘∙║∙└────┘∙└─────┘∙║
║∙∙∙∙∙∙∙∙∙∙∙∙∙∙∙∙║∙∙∙∙∙∙∙∙∙∙∙∙∙∙∙0║
╚════════════════╩════════════════╝